###############
#             #
# # # ### # # #
# # #     # # #
# # # # # # # #
#     #  #    #
# ### # # ### #
#     # #     #
# ### # # ### #
#    #  #     #
# # # # # # # #
# # #     # # #
# # # ### # # #
#             #
###############