###############
#             #
# ##### ##### #
#   #     #   #
# #   # #   # #
# ### # # ### #
#     # #     #
# # # # # # # #
#   #     #   #
### ### ### ###
#     # #     #
# ### # # ### #
#   #     #   #
#             #
###############