###############
#             #
# # ### ## ## #
#     #     # #
# #     #     #
# ## #  ####  #
#             #
# ### ##### ###
#     #   #   #
# # ##### ## ##
#             #
# # # # # # # #
#             #
#             #
###############