###############
#             #
# ######### # #
#     #     # #
### # # # ### #
#   #   #     #
# ### ### ### #
#             #
# ### ### ### #
#     #   #   #
# ### # # ### #
# #     #     #
# # ######### #
#             #
###############