###############
#             #
# ### # # ### #
#   # # # #   #
# # # # # # # #
# #         # #
# # ### ### # #
#             #
# # ### ### # #
# #         # #
# # # # # # # #
#   # # # #   #
# # # # # # # #
#             #
###############